11000111111111111111
10000100000000000000
00000100000000000000
00000100000000000000
00000100000000000000
11111100000001111111
00000000000000000000
00000000020000000000
00000000000000000000
11111111111111111111
00000010000000000000
00000010000000000000
00000010000000000000
00000010000000000000
00000010000000000000