11111111111111111111
10000000000000000001
10000000000000000001
00000100000001000000
00000100000001000000
00000100111001000000
00000000000000000000
00000000002000000000
00000000000000000000
00000100000001000000
00000100000001000000
00000100111001000000
10000000000000000001
10000000000000000001
11111111111111111111