00000000000001000000
00000000000001000000
00000000000001000000
11111110000001000000
00000000000001000000
00000000000001000000
00000000000000000000
00000000020000000000
00000000000000000000
00000100000011111111
00000100000000000000
00000100000000000000
00000100000000000000
00000100000000000000
00000100000000000000