11000000000000000011
10000000000000000001
00000000000000000000
00000000000000000000
00000011111110000000
00000000000000000000
00000000000000000000
00000000020000000000
00000000000000000000
00000000000000000000
00000011111110000000
00000000000000000000
00000000000000000000
10000000000000000001
11000000000000000011